103 103 103 103 103 103 103 103 103 103 103 103 103 103 103 103 103 103 103 103 103 103 103 103 103 103 103 103 103 103 103 103 103 103 103 103 103 103 103 103 103 103 103 103 103 103 103 103 103 103 999
103 103 103 103 103 103 103 103 103 103 103 103 103 103 103 103 103 103 103 103 103 103 103 103 103 103 103 103 103 103 103 103 103 103 103 103 103 103 103 103 103 103 103 103 103 103 103 103 103 103 999
103 103 103 103 103 103 103 103 103 103 103 103 103 103 103 103 103 103 103 103 103 103 103 103 103 103 103 103 103 103 103 103 103 103 103 103 103 103 103 103 103 103 103 103 103 103 103 103 103 103 999
103 103 103 103 103 100 100 100 100 100 100 100 100 100 100 100 100 100 100 100 100 100 100 100 100 100 100 100 100 100 100 100 100 100 100 100 100 100 100 100 100 100 100 100 205 103 103 103 103 103 999
103 103 103 103 103 100 911 100 100 100 100 100 100 100 100 100 100 100 100 100 100 100 100 100 100 100 100 100 100 100 100 100 100 100 100 100 100 100 100 100 100 100 100 100 100 103 103 103 103 103 999
103 103 103 103 103 100 100 100 100 100 100 100 105 100 100 105 100 100 100 100 100 100 100 100 100 100 100 100 100 100 100 100 100 100 100 100 911 100 100 100 100 100 100 100 100 103 103 103 103 103 999
103 103 103 103 103 914 100 100 100 100 100 100 105 105 100 105 100 105 105 100 100 100 100 100 100 100 100 100 100 100 100 100 100 100 100 102 100 102 100 100 100 100 100 100 100 103 103 103 103 103 999
103 103 103 103 103 100 100 100 100 100 100 100 105 100 100 105 100 105 105 100 100 100 100 100 100 100 100 100 100 100 100 100 100 100 100 102 100 102 100 912 100 100 100 100 100 103 103 103 103 103 999
103 103 103 103 103 100 100 100 100 100 100 100 105 100 100 105 100 105 105 100 100 100 100 100 100 100 100 100 100 100 100 100 100 100 100 102 102 102 100 100 100 100 914 100 100 103 103 103 103 103 999
103 103 103 103 103 100 100 100 100 100 100 100 105 100 100 105 100 100 100 912 100 100 100 100 100 100 100 100 100 100 100 100 100 100 100 102 100 102 100 100 100 100 914 100 100 103 103 103 103 103 999
103 103 103 103 103 107 107 107 107 107 107 107 105 105 100 105 100 100 100 100 100 103 103 103 103 103 100 100 100 100 100 100 100 100 100 102 100 102 100 912 100 100 100 100 100 103 103 103 103 103 999
103 103 103 103 103 100 100 100 100 100 100 100 100 100 100 105 100 105 105 100 100 103 904 904 904 103 100 100 100 100 100 100 100 100 100 102 100 102 100 100 100 100 100 100 100 103 103 103 103 103 999
103 103 103 103 103 100 107 107 107 107 107 107 107 107 107 107 100 105 105 100 100 103 904 904 904 103 100 100 100 100 100 100 100 100 100 100 100 100 100 100 100 100 100 100 100 103 103 103 103 103 999
103 103 103 103 103 100 100 100 100 100 100 100 100 100 100 100 100 105 105 100 100 103 904 904 904 103 100 100 100 100 100 100 100 100 100 100 100 100 100 100 100 100 100 100 100 103 103 103 103 103 999
103 103 103 103 103 100 100 100 100 901 901 901 100 100 100 100 100 105 105 100 100 103 904 904 904 103 100 100 100 100 100 100 100 100 100 100 911 100 100 100 100 100 100 100 100 103 103 103 103 103 999
103 103 103 103 103 100 100 100 100 100 100 100 100 100 100 100 100 105 105 100 100 103 103 100 103 103 100 100 100 100 100 100 100 100 100 100 100 100 100 100 102 102 102 100 100 103 103 103 103 103 999
103 103 103 103 103 100 100 901 100 901 105 105 100 100 100 100 100 105 105 100 100 100 100 100 100 100 100 100 100 100 100 100 100 100 100 100 100 100 100 100 100 100 100 100 100 103 103 103 103 103 999
103 103 103 103 103 100 100 901 100 901 105 105 100 100 100 100 100 100 100 100 100 100 901 100 901 100 100 100 100 100 100 100 100 100 100 100 100 100 100 100 100 100 100 100 100 103 103 103 103 103 999
103 103 103 103 103 100 100 901 100 901 100 100 100 100 100 100 100 100 100 100 100 100 901 100 901 100 100 100 100 100 100 100 100 100 100 100 100 100 100 100 100 100 100 100 100 103 103 103 103 103 999
107 107 107 107 107 107 107 107 100 107 107 107 107 107 107 107 107 107 107 107 107 107 107 100 107 107 107 107 107 107 107 107 107 107 107 107 107 107 107 107 107 107 107 107 107 107 107 107 107 107 999 
904 904 904 904 904 904 904 904 100 904 904 904 904 904 904 904 904 904 904 904 904 904 904 100 904 904 904 904 904 904 904 904 904 904 904 904 904 904 904 904 904 904 904 904 904 904 904 904 904 904 999 
107 107 107 107 107 107 107 107 100 107 107 107 107 107 107 107 107 107 107 107 107 107 107 100 107 107 107 107 107 107 107 107 107 107 107 107 107 107 107 107 107 107 107 107 107 107 107 107 107 107 999 
103 103 103 103 103 100 100 901 100 901 100 100 100 100 911 100 100 100 901 100 100 100 901 100 901 100 100 100 100 100 100 100 100 100 100 100 100 100 100 100 100 100 100 100 100 103 103 103 103 103 999
103 103 103 103 103 100 100 901 100 901 100 100 100 100 100 100 100 100 100 100 100 100 901 100 901 100 100 100 100 100 100 100 100 100 100 100 100 100 100 100 100 100 100 100 100 103 103 103 103 103 999
103 103 103 103 103 100 100 901 100 901 100 100 100 100 100 100 100 100 100 100 100 100 901 100 901 100 100 100 100 100 100 100 100 100 100 100 100 100 100 100 100 100 921 100 100 103 103 103 103 103 999
103 103 103 103 103 100 100 100 100 100 102 100 102 100 102 100 100 100 100 100 100 100 100 100 100 100 100 100 100 100 100 100 100 100 100 100 100 100 100 100 100 100 100 100 100 103 103 103 103 103 999
103 103 103 103 103 100 100 921 100 921 100 100 100 100 100 100 100 100 100 100 100 100 921 100 921 100 100 100 100 904 904 904 904 904 904 904 904 904 100 100 100 100 100 100 100 103 103 103 103 103 999
103 103 103 103 103 100 100 100 100 100 102 100 102 100 102 204 100 100 100 100 100 100 100 100 100 100 100 100 100 904 904 904 904 904 904 904 904 904 100 100 100 108 100 108 100 103 103 103 103 103 999
103 103 103 103 103 100 100 100 100 100 100 100 100 100 100 100 100 100 100 100 100 100 100 100 100 100 100 100 100 904 904 100 100 100 100 100 904 904 100 100 100 100 100 100 100 103 103 103 103 103 999
103 103 103 103 103 107 107 107 107 107 102 100 102 100 102 100 100 100 100 100 100 100 100 100 100 100 100 100 100 904 904 100 100 100 100 100 904 904 100 100 100 108 100 108 100 103 103 103 103 103 999
103 103 103 103 103 100 100 100 100 100 100 100 100 100 100 100 100 100 100 100 100 100 100 100 100 100 100 100 100 904 904 100 100 100 100 100 904 904 100 100 100 100 100 100 100 103 103 103 103 103 999
103 103 103 103 103 100 100 100 100 100 100 100 100 100 100 100 100 100 100 100 100 100 100 100 100 100 100 100 100 904 904 100 100 100 100 100 904 904 100 100 100 108 100 108 100 103 103 103 103 103 999
103 103 103 103 103 100 100 102 102 100 102 100 100 100 100 100 100 100 100 100 100 204 100 100 100 100 100 100 100 904 904 904 904 100 904 904 904 904 100 100 100 100 100 100 100 103 103 103 103 103 999
103 103 103 103 103 100 100 102 102 102 102 100 100 100 100 100 100 100 100 100 100 100 100 100 100 100 100 100 100 904 904 904 904 912 904 904 904 904 100 100 100 100 100 100 100 103 103 103 103 103 999
103 103 103 103 103 100 100 102 102 102 102 100 100 100 100 100 100 100 100 100 100 100 100 100 204 100 100 100 100 904 904 904 904 100 904 904 904 904 100 100 100 100 100 100 100 103 103 103 103 103 999
103 103 103 103 103 100 100 102 102 102 102 100 100 100 100 100 921 100 100 100 100 100 100 100 100 100 100 100 100 100 100 100 100 100 100 100 100 100 100 100 100 100 100 100 100 103 103 103 103 103 999
103 103 103 103 103 100 100 102 102 100 102 100 100 100 100 100 100 100 100 100 100 100 100 100 100 100 100 100 100 100 100 100 100 100 100 100 100 100 100 921 904 904 921 100 100 103 103 103 103 103 999
103 103 103 103 103 100 100 100 100 100 100 911 100 100 100 100 100 100 100 100 100 100 100 100 100 100 100 100 100 100 100 100 100 100 100 100 100 100 100 904 100 100 100 100 100 103 103 103 103 103 999
103 103 103 103 103 100 100 106 106 106 106 106 100 100 100 100 100 100 100 100 100 100 100 100 100 100 100 100 100 100 100 100 100 100 100 100 100 100 100 904 100 100 100 100 100 103 103 103 103 103 999
103 103 103 103 103 100 100 106 100 100 100 106 100 100 107 107 107 107 107 100 107 107 107 107 107 107 100 100 107 107 107 107 100 107 107 107 107 100 100 921 100 100 100 100 100 103 103 103 103 103 999
103 103 103 103 103 100 100 106 100 100 100 106 100 100 100 100 100 100 100 100 100 100 100 100 100 100 100 100 100 100 100 100 100 100 108 100 100 100 108 100 100 100 100 100 100 103 103 103 103 103 999
103 103 103 103 103 100 100 106 100 100 100 106 100 100 100 100 100 100 100 100 100 100 100 100 100 100 100 100 100 100 100 100 108 100 100 100 108 100 100 100 100 100 100 100 100 103 103 103 103 103 999
103 103 103 103 103 100 100 100 100 901 100 106 100 100 100 100 100 100 100 100 100 100 100 100 100 100 100 100 100 100 100 100 100 100 108 100 100 100 108 100 100 100 100 100 100 103 103 103 103 103 999
103 103 103 103 103 100 100 100 100 901 100 106 912 100 100 100 100 100 100 100 100 100 100 100 100 100 100 100 100 100 100 100 108 100 100 100 108 100 100 100 100 100 100 100 100 103 103 103 103 103 999
103 103 103 103 103 100 100 100 100 901 100 106 100 100 100 100 100 100 100 100 100 100 100 100 100 100 100 100 100 100 100 100 100 100 108 100 100 100 108 100 100 100 100 100 100 103 103 103 103 103 999
103 103 103 103 103 100 100 100 100 901 100 100 100 100 100 100 100 100 100 100 100 100 100 100 100 100 100 100 100 100 100 100 108 100 100 100 108 100 100 100 100 100 100 100 100 103 103 103 103 103 999
103 103 103 103 103 200 100 100 100 901 100 100 100 100 100 100 100 100 100 100 100 100 100 100 100 100 100 100 100 100 100 100 100 100 108 100 100 100 108 100 100 100 100 100 100 103 103 103 103 103 999
103 103 103 103 103 103 103 103 103 103 103 103 103 103 103 103 103 103 103 103 103 103 103 103 103 103 103 103 103 103 103 103 103 103 103 103 103 103 103 103 103 103 103 103 103 103 103 103 103 103 999
103 103 103 103 103 103 103 103 103 103 103 103 103 103 103 103 103 103 103 103 103 103 103 103 103 103 103 103 103 103 103 103 103 103 103 103 103 103 103 103 103 103 103 103 103 103 103 103 103 103 999
103 103 103 103 103 103 103 103 103 103 103 103 103 103 103 103 103 103 103 103 103 103 103 103 103 103 103 103 103 103 103 103 103 103 103 103 103 103 103 103 103 103 103 103 103 103 103 103 103 103 999




