103 103 103 103 103 103 103 103 103 103 103 103 103 103 103 103 103 103 103 103 103 103 103 103 103 103 103 103 103 103 103 103 103 103 103 103 103 103 103 103 103 103 103 103 103 103 103 103 103 103 999
103 103 103 103 103 103 103 103 103 103 103 103 103 103 103 103 103 103 103 103 103 103 103 103 103 103 103 103 103 103 103 103 103 103 103 103 103 103 103 103 103 103 103 103 103 103 103 103 103 103 999
103 103 103 103 103 103 103 103 103 103 103 103 103 103 103 103 103 103 103 103 103 103 103 103 103 103 103 103 103 103 103 103 103 103 103 103 103 103 103 103 103 103 103 103 103 103 103 103 103 103 999
103 103 103 103 103 204 100 921 100 100 100 100 100 100 100 100 100 100 100 100 100 100 100 100 100 100 100 100 100 100 100 100 100 100 100 205 100 100 100 100 100 100 921 100 204 103 103 103 103 103 999
103 103 103 103 103 204 100 921 100 100 108 100 100 100 100 100 931 100 100 100 100 100 931 100 100 100 100 100 100 103 100 100 100 911 100 100 100 100 100 100 100 100 100 100 100 103 103 103 103 103 999
103 103 103 103 103 204 100 921 100 100 100 100 100 100 100 100 100 100 100 100 100 100 100 100 100 100 100 100 100 103 100 100 100 100 100 100 100 100 100 100 100 100 921 100 100 103 103 103 103 103 999
103 103 103 103 103 107 107 107 107 107 107 107 107 107 107 107 107 107 107 107 107 107 107 107 107 107 107 107 100 103 107 107 107 107 107 107 107 107 107 107 107 107 107 107 100 103 103 103 103 103 999
103 103 103 103 103 941 100 100 100 100 108 100 100 108 100 100 108 100 100 108 100 941 100 100 100 100 100 103 912 103 100 100 100 100 100 100 100 100 100 103 100 100 100 100 100 103 103 103 103 103 999
103 103 103 103 103 100 100 100 100 100 108 100 100 108 100 100 108 100 100 108 100 103 103 103 103 103 103 103 100 103 103 103 103 103 103 103 100 100 100 103 100 100 911 100 100 103 103 103 103 103 999
103 103 103 103 103 100 100 100 100 100 108 100 100 108 100 100 108 100 100 108 100 103 100 100 100 100 100 100 911 100 100 100 100 100 100 103 100 100 100 103 100 100 100 100 100 103 103 103 103 103 999
103 103 103 103 103 100 100 100 100 100 100 100 100 108 100 100 108 100 100 108 100 103 103 103 103 103 103 103 100 103 103 103 103 103 103 103 100 100 100 103 100 901 901 901 100 103 103 103 103 103 999
103 103 103 103 103 100 100 100 100 100 100 100 100 100 100 100 100 100 100 100 100 100 100 100 100 100 100 103 100 103 100 100 100 100 100 100 100 100 100 103 100 100 901 901 100 103 103 103 103 103 999
103 103 103 103 103 100 103 100 100 100 912 100 100 100 103 100 100 100 100 100 100 100 100 100 100 100 100 103 100 103 100 100 100 100 100 100 100 100 100 103 100 100 100 911 100 103 103 103 103 103 999
103 103 103 103 103 100 100 103 100 100 100 100 100 103 100 100 100 100 100 100 100 103 103 103 103 103 103 103 100 103 103 103 103 103 103 103 100 100 100 103 100 100 100 100 100 103 103 103 103 103 999
103 103 103 103 103 100 100 100 103 100 100 100 103 100 100 100 100 100 100 100 100 103 100 100 100 100 100 100 913 100 100 100 100 100 100 103 100 100 100 103 103 100 100 100 100 103 103 103 103 103 999
103 103 103 103 103 100 100 100 100 904 904 904 100 100 100 100 100 100 100 100 100 103 103 103 103 103 103 103 100 103 103 103 103 103 103 103 100 100 100 103 103 103 100 100 100 103 103 103 103 103 999
103 103 103 103 103 100 100 100 100 904 103 904 100 100 100 100 100 100 100 100 100 100 100 100 100 100 100 103 100 103 100 100 100 100 100 100 100 100 100 100 100 103 100 100 100 103 103 103 103 103 999
103 103 103 103 103 100 911 100 100 904 904 904 100 100 914 100 100 100 107 100 100 100 100 100 100 100 100 103 100 103 100 100 100 100 100 100 100 100 100 100 100 103 100 100 100 103 103 103 103 103 999
103 103 103 103 103 100 100 100 103 100 100 100 103 100 100 100 100 100 100 100 100 103 103 103 103 103 103 103 100 103 103 103 103 103 103 103 100 100 100 100 100 103 100 100 100 103 103 103 103 103 999
103 103 103 103 103 100 100 103 100 100 100 100 100 103 100 100 100 100 100 100 100 103 100 100 100 100 100 100 911 100 100 100 100 100 100 103 100 100 100 100 100 103 100 100 100 103 103 103 103 103 999
103 103 103 103 103 100 103 100 100 100 914 100 100 100 103 100 100 100 100 100 100 103 103 103 103 103 103 103 100 103 103 103 103 103 103 103 904 103 100 100 100 103 100 100 100 103 103 103 103 103 999
103 103 103 103 103 100 100 100 100 100 100 100 100 100 100 100 100 100 100 100 100 100 100 100 100 100 100 103 100 103 100 100 100 100 100 100 904 103 100 100 100 106 106 100 100 103 103 103 103 103 999
103 103 103 103 103 107 107 100 100 100 100 100 100 100 100 100 100 100 100 100 100 100 100 100 100 100 100 103 100 103 100 100 100 100 100 100 904 103 931 100 100 106 106 100 100 103 103 103 103 103 999
103 103 103 103 103 904 904 107 107 107 100 100 100 100 100 100 100 100 100 100 100 100 100 100 100 931 100 103 100 103 103 100 100 100 100 904 904 103 100 100 100 106 106 100 100 103 103 103 103 103 999
103 103 103 103 103 904 904 904 904 904 107 107 107 100 100 100 100 100 100 100 100 100 100 100 100 100 100 100 100 100 103 100 100 100 904 904 904 103 100 100 911 100 100 100 100 103 103 103 103 103 999
103 103 103 103 103 904 904 904 904 904 904 108 904 100 100 100 100 100 100 100 100 100 100 100 100 100 100 103 100 103 103 100 100 904 904 904 904 103 100 100 100 106 106 100 100 103 103 103 103 103 999
103 103 103 103 103 107 107 107 107 107 108 108 107 107 107 107 107 107 107 107 100 100 100 100 100 100 100 931 100 100 100 100 904 904 904 904 904 103 100 100 100 106 106 100 100 103 103 103 103 103 999
103 103 103 103 103 100 100 100 100 100 100 100 100 100 100 100 100 100 100 108 100 107 107 107 107 107 107 107 107 107 107 107 107 107 107 107 107 107 100 100 100 106 106 100 100 103 103 103 103 103 999
103 103 103 103 103 100 100 100 100 100 100 100 100 100 100 100 100 100 100 108 100 100 100 100 100 911 100 100 100 100 921 100 106 100 100 100 100 913 100 100 100 911 100 100 100 103 103 103 103 103 999
103 103 103 103 103 100 100 921 100 100 921 100 100 921 100 100 921 100 100 108 100 100 100 100 108 108 108 100 100 100 100 100 100 100 100 100 100 100 100 931 106 106 106 106 100 103 103 103 103 103 999
103 103 103 103 103 100 100 100 100 100 100 100 100 100 100 100 100 100 100 108 100 100 100 100 108 100 100 100 912 100 100 100 912 100 100 100 100 106 100 100 106 106 106 106 100 103 103 103 103 103 999
103 103 103 103 103 100 100 100 100 100 100 100 100 100 100 100 100 100 100 108 100 100 100 100 108 100 100 100 100 100 100 100 100 100 100 100 100 106 100 100 100 100 100 100 100 103 103 103 103 103 999
103 103 103 103 103 100 100 100 100 100 100 100 100 100 100 100 100 100 100 108 100 100 100 914 108 912 100 100 100 100 100 100 100 911 100 100 100 106 921 100 100 100 100 100 100 103 103 103 103 103 999
103 103 103 103 103 100 931 100 100 931 100 100 931 100 100 100 921 100 100 108 100 100 100 100 108 100 100 100 100 100 100 100 100 100 100 100 100 106 100 100 100 100 100 100 921 103 103 103 103 103 999
103 103 103 103 103 106 100 106 100 106 100 106 100 106 100 100 100 100 100 108 100 100 100 100 108 100 100 100 100 100 100 100 100 911 100 100 100 106 921 100 100 100 100 100 100 103 103 103 103 103 999
103 103 103 103 103 100 100 100 100 100 100 100 100 100 100 100 100 100 100 100 100 100 100 100 108 100 100 100 100 100 100 100 100 100 100 100 100 106 100 100 100 100 100 100 921 103 103 103 103 103 999
103 103 103 103 103 100 106 100 106 100 106 100 106 100 100 100 100 100 100 108 100 100 912 100 108 100 100 100 100 100 100 100 100 911 100 100 100 106 921 100 100 100 100 100 100 103 103 103 103 103 999
103 103 103 103 103 100 100 100 100 100 100 100 100 100 100 100 921 100 100 108 100 100 100 100 108 100 100 100 100 100 100 100 100 100 100 931 100 106 100 100 100 100 100 100 100 103 103 103 103 103 999
103 103 103 103 103 106 100 106 100 106 100 106 100 106 100 100 100 100 100 100 100 100 100 100 108 100 100 100 100 100 100 100 100 911 100 100 100 106 100 100 931 100 100 100 100 103 103 103 103 103 999
103 103 103 103 103 100 100 100 100 100 100 100 100 100 100 100 100 100 100 108 100 100 100 100 108 100 100 100 100 100 100 100 100 100 100 100 100 106 100 100 100 100 100 100 100 103 103 103 103 103 999
103 103 103 103 103 100 106 100 106 100 106 100 106 100 100 100 100 100 100 108 100 100 100 100 108 100 100 921 100 100 100 100 100 100 100 100 100 106 100 100 100 100 100 100 100 103 103 103 103 103 999
103 103 103 103 103 100 100 100 100 100 100 100 100 100 100 100 921 100 100 108 100 100 108 108 108 108 108 108 108 108 108 108 108 108 108 100 100 100 100 100 100 100 100 100 100 103 103 103 103 103 999
103 103 103 103 103 106 100 106 100 106 100 106 100 106 100 100 100 100 100 100 100 108 108 108 108 100 100 108 108 108 100 100 108 108 108 108 100 100 100 100 100 100 100 100 100 103 103 103 103 103 999
103 103 103 103 103 100 941 100 100 100 100 100 100 100 100 100 100 100 100 108 108 108 108 108 108 100 108 108 108 108 100 108 108 108 108 108 108 100 100 100 100 100 100 100 100 103 103 103 103 103 999
103 103 103 103 103 100 100 100 100 100 100 108 108 108 100 100 100 100 100 100 100 100 911 100 100 100 100 100 100 100 100 100 100 100 931 100 108 108 100 100 100 100 100 100 100 103 103 103 103 103 999
103 103 103 103 103 100 100 100 100 100 100 108 904 108 100 100 100 100 100 108 100 100 100 911 100 100 100 100 100 100 100 100 100 100 100 100 108 100 100 931 100 100 100 100 100 103 103 103 103 103 999
103 103 103 103 103 200 100 100 100 100 100 108 904 108 100 100 100 100 100 108 100 100 100 100 911 100 100 100 100 100 100 100 100 100 100 100 100 100 100 100 100 100 931 100 100 103 103 103 103 103 999
103 103 103 103 103 103 103 103 103 103 103 103 103 103 103 103 103 103 103 103 103 103 103 103 103 103 103 103 103 103 103 103 103 103 103 103 103 103 103 103 103 103 103 103 103 103 103 103 103 103 999
103 103 103 103 103 103 103 103 103 103 103 103 103 103 103 103 103 103 103 103 103 103 103 103 103 103 103 103 103 103 103 103 103 103 103 103 103 103 103 103 103 103 103 103 103 103 103 103 103 103 999
103 103 103 103 103 103 103 103 103 103 103 103 103 103 103 103 103 103 103 103 103 103 103 103 103 103 103 103 103 103 103 103 103 103 103 103 103 103 103 103 103 103 103 103 103 103 103 103 103 103 999