103 103 103 103 103 103 103 103 103 103 103 103 103 103 103 103 103 103 103 103 103 103 103 103 103 103 103 103 103 103 103 103 103 103 103 103 103 103 103 103 103 103 103 103 103 103 103 103 103 103 999
103 103 103 103 103 103 103 103 103 103 103 103 103 103 103 103 103 103 103 103 103 103 103 103 103 103 103 103 103 103 103 103 103 103 103 103 103 103 103 103 103 103 103 103 103 103 103 103 103 103 999
103 103 103 103 103 103 103 103 103 103 103 103 103 103 103 103 103 103 103 103 103 103 103 103 103 103 103 103 103 103 103 103 103 103 103 103 103 103 103 103 103 103 103 103 103 103 103 103 103 103 999
103 103 103 103 103 100 100 100 100 100 100 100 100 100 100 105 100 100 100 100 100 100 100 105 100 100 100 100 100 100 100 100 100 100 100 100 100 100 100 100 100 100 100 100 100 103 103 103 103 103 999
103 103 103 103 103 100 100 100 100 100 100 100 100 100 100 105 100 100 100 100 100 100 100 105 100 100 100 100 100 100 100 100 100 100 100 100 100 100 100 100 100 100 100 100 100 103 103 103 103 103 999
103 103 103 103 103 100 100 100 100 100 100 100 100 100 100 105 100 100 100 100 100 100 100 105 100 100 100 100 100 100 100 100 100 100 100 100 100 100 931 100 100 100 100 100 100 103 103 103 103 103 999
103 103 103 103 103 100 100 100 100 100 100 100 100 100 100 105 100 100 100 100 100 100 100 105 100 100 100 100 100 100 100 100 100 100 100 100 100 100 100 100 100 100 100 100 100 103 103 103 103 103 999
103 103 103 103 103 100 100 100 100 100 100 100 100 100 100 105 100 913 100 100 100 911 100 105 100 100 100 100 100 100 100 100 100 100 100 100 100 100 100 100 100 100 100 100 100 103 103 103 103 103 999
103 103 103 103 103 100 100 914 100 912 100 100 100 100 100 105 100 100 100 100 100 100 100 105 100 100 100 100 100 904 100 100 100 100 100 100 100 100 100 100 100 100 100 100 100 103 103 103 103 103 999
103 103 103 103 103 100 105 100 105 100 105 100 100 100 100 105 100 100 100 100 100 100 100 105 100 100 100 100 100 100 100 100 100 100 100 100 100 100 921 100 100 100 921 100 100 103 103 103 103 103 999
103 103 103 103 103 100 100 100 100 100 100 100 100 100 100 105 100 100 100 100 100 100 100 105 100 100 100 100 100 100 100 100 100 100 100 100 100 100 100 100 108 100 100 100 100 103 103 103 103 103 999
103 103 103 103 103 100 105 100 105 100 105 100 100 100 107 107 921 107 107 921 107 107 921 107 100 100 100 904 904 100 100 100 100 100 100 100 100 100 100 108 108 108 100 100 100 103 103 103 103 103 999
103 103 103 103 103 100 100 100 100 100 100 100 100 100 100 100 100 100 100 100 100 100 100 100 100 100 100 904 904 100 904 100 100 100 100 100 100 100 100 100 108 205 100 100 100 103 103 103 103 103 999
103 103 103 103 103 100 105 100 105 100 105 100 100 100 100 100 100 100 100 100 100 100 100 100 100 100 100 904 904 100 904 100 100 100 100 100 100 100 921 100 100 100 921 100 100 103 103 103 103 103 999
103 103 103 103 103 100 100 100 921 100 100 100 100 100 100 100 100 100 100 100 100 100 100 100 100 100 100 100 100 100 100 100 100 100 100 100 100 100 100 100 100 100 100 100 100 103 103 103 103 103 999
103 103 103 103 103 100 105 100 105 100 105 100 100 100 100 100 100 100 100 100 100 100 100 100 100 100 100 100 100 100 100 100 100 100 103 103 103 100 100 100 100 100 100 100 100 103 103 103 103 103 999
103 103 103 103 103 100 100 100 100 100 100 100 100 100 100 100 100 912 100 100 100 912 100 100 100 100 904 100 100 100 100 100 100 100 103 904 103 100 100 100 100 100 100 912 100 103 103 103 103 103 999
103 103 103 103 103 100 105 100 105 100 105 100 100 100 100 100 100 100 100 100 100 100 100 100 100 100 100 100 100 100 100 100 100 100 100 904 100 100 100 100 100 100 100 100 100 103 103 103 103 103 999
103 103 103 103 103 100 100 100 100 100 100 100 100 100 100 100 100 100 100 100 100 100 100 100 100 100 100 100 100 100 100 100 100 100 100 904 100 100 100 100 100 100 100 100 100 103 103 103 103 103 999
103 103 103 103 103 100 105 100 105 100 105 100 100 100 100 100 100 100 100 100 100 100 100 100 100 100 100 100 100 100 100 100 100 100 100 904 904 100 100 100 100 100 100 100 100 103 103 103 904 904 999
103 103 103 103 103 100 100 100 100 100 100 100 100 105 105 100 100 100 100 100 100 100 100 100 100 100 100 100 100 100 100 100 100 100 100 100 904 100 107 107 107 107 107 100 100 904 904 904 904 103 999
103 103 103 103 103 100 100 100 100 100 100 100 100 105 105 100 100 100 100 100 100 100 100 100 100 100 100 100 100 100 100 100 100 100 100 100 904 100 100 100 100 100 100 100 100 904 103 103 103 103 999
103 103 103 103 103 100 100 100 100 914 100 100 100 100 100 100 100 100 100 100 100 100 100 100 100 100 100 100 100 100 100 100 100 100 100 100 904 904 100 100 100 100 100 100 100 904 103 103 103 103 999
103 103 103 103 103 100 100 100 108 100 108 100 100 100 100 100 100 100 100 100 100 100 100 100 100 100 100 100 100 100 100 100 100 100 100 100 100 904 100 100 100 904 904 904 904 904 103 103 103 103 999
103 103 103 103 103 100 100 100 108 100 108 100 100 100 100 100 100 100 100 100 100 100 100 100 100 100 100 100 100 100 100 904 100 100 100 100 100 904 904 100 100 904 100 100 100 103 103 103 103 103 999
103 103 103 103 103 100 108 108 108 108 108 108 108 100 100 914 100 100 100 100 100 100 100 100 100 100 100 100 100 100 100 904 904 904 100 100 100 100 904 904 904 904 100 100 100 103 103 103 103 103 999
103 103 103 103 103 100 100 100 108 108 108 100 100 100 100 100 914 100 100 103 100 103 103 103 100 100 100 100 100 100 921 904 904 904 904 100 100 100 100 100 100 100 100 100 100 103 103 103 103 103 999
103 103 103 103 103 100 100 100 108 100 108 100 100 100 100 100 100 914 100 103 100 103 108 103 100 100 100 100 100 100 904 904 904 904 904 921 100 100 100 100 100 100 100 100 100 103 103 103 103 103 999
103 103 103 103 103 100 100 100 108 100 108 100 100 100 100 100 100 100 100 103 100 100 100 103 100 100 100 100 100 100 904 904 904 904 904 904 904 100 100 100 913 100 100 100 100 103 103 103 103 103 999
103 103 103 103 103 100 100 100 100 912 100 100 100 100 100 100 100 100 100 103 108 103 100 103 100 100 100 100 100 100 904 904 904 904 904 904 904 100 100 100 100 100 100 912 100 103 103 103 103 103 999
103 103 103 103 103 100 100 100 100 100 100 100 100 100 100 100 100 100 100 103 103 103 100 103 100 100 100 100 100 904 904 904 904 904 904 904 904 912 100 100 100 100 100 100 100 103 103 103 103 103 999
103 103 103 103 103 100 107 107 100 107 107 107 107 107 100 100 100 100 100 100 100 100 100 100 100 100 100 100 100 904 904 904 904 904 904 904 904 100 100 100 100 100 100 100 100 103 103 103 103 103 999
103 103 103 103 103 100 100 100 100 100 100 921 100 100 100 100 100 100 100 100 100 100 100 100 100 100 100 100 100 904 904 904 904 904 904 904 100 100 901 901 901 901 901 100 100 103 103 103 103 103 999
103 103 103 103 103 100 100 107 107 107 100 100 100 107 107 107 107 107 107 100 100 100 100 100 100 100 100 100 100 100 904 904 904 904 904 904 100 100 901 100 100 204 901 100 100 103 103 103 103 103 999
103 103 103 103 103 100 921 100 100 100 100 100 100 100 100 100 100 100 100 100 100 100 100 103 103 103 100 100 100 100 921 904 904 100 921 100 100 100 901 901 100 901 901 100 100 103 103 103 103 103 999
103 103 103 103 103 100 100 100 108 100 108 100 100 100 100 100 100 100 100 100 100 100 100 103 100 103 100 100 100 100 100 100 100 100 100 100 100 100 100 901 100 901 100 100 912 103 103 103 103 103 999
103 103 103 103 103 100 911 100 100 921 100 911 100 100 100 100 100 100 100 100 100 100 100 103 100 103 103 103 100 100 100 100 100 100 100 100 100 100 100 901 100 901 100 100 100 103 103 103 103 103 999
103 103 103 103 103 100 100 100 108 100 108 100 100 100 100 100 100 100 100 941 100 100 100 103 100 100 100 103 100 107 107 107 107 107 107 107 100 100 100 901 100 901 100 100 100 103 103 103 103 103 999
103 103 103 103 103 100 921 100 100 100 100 100 100 100 100 100 100 100 100 100 100 100 100 103 100 103 100 103 100 100 100 100 100 100 100 100 100 100 100 901 100 901 100 100 100 103 103 103 103 103 999
103 103 103 103 103 100 100 100 100 100 100 100 100 100 100 100 100 100 100 100 100 100 100 103 100 103 100 103 100 100 100 100 100 100 100 100 100 100 100 100 100 100 100 100 100 103 103 103 103 103 999
103 103 103 103 103 100 100 100 100 912 100 100 100 100 100 100 100 100 100 100 100 100 100 103 912 103 100 103 103 103 103 103 100 103 103 103 103 103 103 103 103 100 100 100 100 103 103 103 103 103 999
103 103 103 103 103 100 100 100 100 100 100 100 931 100 100 100 904 904 904 904 904 904 904 103 100 103 100 100 100 100 100 100 100 103 100 100 100 100 100 100 103 100 100 100 100 103 103 103 103 103 999
103 103 103 103 103 100 100 100 100 100 100 100 100 100 100 100 904 108 904 108 904 108 904 103 100 103 100 100 100 100 100 100 100 103 100 100 100 100 103 100 103 103 103 103 103 103 103 103 103 103 999
103 103 103 103 103 100 100 103 103 103 100 100 100 103 103 103 904 904 904 904 904 904 904 103 100 103 103 103 103 103 103 100 100 103 100 100 100 100 103 100 100 100 100 100 100 103 103 103 103 103 999
103 103 103 103 103 100 100 103 100 103 100 100 100 103 100 103 107 107 107 107 107 107 107 107 100 100 100 100 100 100 103 100 100 103 100 100 100 100 103 100 100 100 100 100 100 103 103 103 103 103 999
103 103 103 103 103 103 103 103 100 103 103 103 103 103 100 913 100 100 100 100 100 100 100 100 100 100 100 100 921 100 103 100 100 103 100 100 100 100 103 100 100 204 204 204 100 103 103 103 103 103 999
103 103 103 103 103 200 100 100 100 100 911 100 100 100 100 103 103 103 100 100 911 100 100 100 100 100 100 100 100 100 103 100 100 100 100 100 100 100 103 100 100 100 100 100 100 103 103 103 103 103 999
103 103 103 103 103 103 103 103 103 103 103 103 103 103 103 103 103 103 103 103 103 103 103 103 103 103 103 103 103 103 103 103 103 103 103 103 103 103 103 103 103 103 103 103 103 103 103 103 103 103 999
103 103 103 103 103 103 103 103 103 103 103 103 103 103 103 103 103 103 103 103 103 103 103 103 103 103 103 103 103 103 103 103 103 103 103 103 103 103 103 103 103 103 103 103 103 103 103 103 103 103 999
103 103 103 103 103 103 103 103 103 103 103 103 103 103 103 103 103 103 103 103 103 103 103 103 103 103 103 103 103 103 103 103 103 103 103 103 103 103 103 103 103 103 103 103 103 103 103 103 103 103 999