103 103 103 103 103 103 103 904 904 904 904 904 904 904 904 904 904 904 904 103 103 103 103 103 103 103 103 103 103 103 103 103 103 103 103 103 103 103 103 103 103 103 103 103 103 103 103 103 103 103 999
103 103 103 103 103 103 103 103 103 103 904 904 904 904 904 904 904 904 103 103 103 103 103 103 103 103 103 103 103 103 103 103 103 103 103 103 103 103 103 103 103 103 103 103 103 103 103 103 103 103 999
103 103 103 103 103 103 103 103 103 103 103 904 904 904 904 904 904 103 103 103 103 103 103 103 103 103 103 103 103 103 103 103 103 103 103 103 103 103 103 103 103 103 103 103 103 103 103 103 103 103 999
103 103 103 103 103 204 901 100 100 100 100 904 904 904 904 904 904 100 100 100 100 108 100 108 100 108 100 108 100 100 100 100 100 100 100 100 100 100 100 100 100 100 100 921 204 103 103 103 103 103 999
103 103 103 103 103 914 901 100 100 100 100 100 904 904 904 100 100 100 100 100 100 108 100 108 100 108 100 108 100 100 100 100 105 100 105 100 105 100 105 100 105 100 105 921 921 103 103 103 103 103 999
103 103 103 103 103 100 901 100 100 100 100 100 100 904 100 100 100 100 100 100 100 100 100 100 100 100 100 100 100 100 100 100 100 931 100 100 100 100 100 931 100 100 100 100 100 103 103 103 103 103 999
103 103 103 103 103 100 901 100 100 100 100 100 100 100 100 100 100 100 100 100 100 100 901 100 100 100 100 100 100 100 100 100 105 100 105 100 105 100 105 100 105 100 105 100 100 103 103 103 103 103 999
103 103 103 103 103 100 901 901 100 100 100 100 100 901 100 901 100 100 100 100 901 100 100 100 901 100 100 100 100 100 100 100 100 100 100 100 100 100 100 100 100 100 100 100 100 103 103 103 103 103 999
103 103 103 103 103 100 100 901 100 100 100 100 100 901 100 901 100 100 100 100 100 100 901 100 100 100 100 100 100 100 100 100 105 100 105 100 105 100 105 100 105 100 105 100 100 103 103 103 103 103 999
103 103 103 103 103 100 100 901 100 100 100 901 100 901 100 901 100 901 100 100 901 100 100 100 901 100 100 100 100 108 100 100 100 100 100 100 100 100 100 100 100 100 100 100 100 103 103 103 103 103 999
103 103 103 103 103 100 100 901 100 100 100 901 100 901 100 901 100 901 100 100 100 912 901 100 100 100 100 100 108 204 108 100 105 100 105 100 105 100 105 100 105 100 105 100 205 103 103 103 103 103 999
103 103 103 103 103 100 901 901 100 100 100 901 100 100 921 100 100 901 100 100 901 100 100 912 901 100 100 100 108 100 108 100 100 100 100 100 921 100 100 100 100 100 921 100 100 103 103 103 103 103 999
103 103 103 103 103 100 901 100 911 100 100 901 100 901 100 901 100 901 100 100 100 100 901 100 100 100 100 100 108 100 108 100 105 100 105 100 105 100 105 100 105 100 105 100 100 103 103 103 103 103 999
103 103 103 103 103 100 901 100 913 100 100 100 100 901 100 901 100 100 100 100 901 100 100 100 901 100 100 100 108 941 108 100 100 100 100 100 100 100 100 100 100 100 100 100 100 103 103 103 103 103 999
103 103 103 103 103 100 901 901 901 901 901 901 100 901 100 901 100 100 100 100 100 100 901 100 100 100 100 100 108 100 108 100 105 100 105 100 105 100 105 100 105 100 105 100 100 103 103 103 103 103 999
103 103 103 103 103 100 100 100 100 100 100 100 100 901 100 901 100 100 100 100 901 100 100 100 901 100 100 100 100 100 108 100 100 100 100 100 100 100 100 100 100 100 100 100 100 103 103 103 103 103 999
103 103 103 103 103 100 100 100 100 100 100 100 100 100 100 100 100 100 100 100 100 100 100 100 100 100 100 100 108 108 108 100 100 100 105 100 105 100 105 100 105 100 105 100 100 103 103 103 103 103 999
103 103 103 103 103 100 100 100 100 100 100 100 100 100 100 100 100 103 103 103 103 100 100 100 100 100 100 100 100 100 100 100 100 100 100 100 921 100 100 100 100 100 100 100 100 103 103 103 103 103 999
103 103 103 103 103 914 100 100 100 100 100 100 100 100 100 100 100 103 100 100 103 100 100 100 100 931 100 100 931 100 100 931 100 100 105 100 105 100 100 100 100 100 100 100 100 103 103 103 103 103 999
103 103 103 103 103 100 100 100 100 100 100 100 100 100 100 100 100 103 100 100 103 100 100 100 100 100 100 100 100 100 100 100 100 100 100 100 100 100 904 904 100 100 100 100 100 103 103 103 103 103 999
103 103 103 103 103 100 100 100 100 100 100 100 100 100 100 100 100 103 912 103 103 100 100 100 100 100 100 100 100 100 100 100 100 100 100 100 100 904 904 904 100 904 904 100 100 103 103 103 103 103 999
103 103 103 103 103 100 100 100 100 100 100 100 100 100 100 100 100 103 100 103 100 100 100 100 100 100 100 100 100 100 100 100 100 100 100 100 904 904 904 904 100 904 904 904 100 103 103 103 103 103 999
103 103 103 103 103 100 100 100 100 100 100 100 100 107 107 107 107 103 100 103 107 107 107 107 107 107 107 100 107 107 107 107 100 100 100 904 904 904 904 904 100 904 904 904 100 103 103 103 103 103 999
103 103 103 103 103 100 100 100 100 100 107 107 107 103 100 100 100 100 100 100 100 100 911 100 100 100 100 100 100 100 100 100 100 100 100 904 904 100 100 100 100 100 904 904 100 103 103 103 103 103 999
103 103 103 103 103 100 100 100 100 911 100 100 100 911 100 100 100 100 100 100 913 100 100 100 100 100 100 100 100 100 100 100 100 100 904 904 904 100 100 100 100 100 904 904 904 103 103 103 103 103 999
103 103 103 103 103 100 100 100 100 100 100 913 100 100 100 100 913 100 103 100 107 107 107 107 107 107 107 107 107 107 107 107 107 904 904 904 904 100 100 931 100 100 904 904 904 103 103 103 103 103 999
103 103 103 103 103 100 107 107 107 107 107 107 107 107 107 107 107 107 107 100 100 100 100 100 100 100 100 100 100 100 100 100 100 904 904 904 904 204 100 100 100 204 904 904 904 103 103 103 103 103 999
103 103 103 103 103 914 911 100 100 100 100 100 100 100 100 100 100 105 105 100 100 100 100 931 100 100 931 100 100 100 100 100 100 904 904 904 904 904 100 100 100 100 904 904 100 103 103 103 103 103 999
103 103 103 103 103 100 100 100 100 100 100 100 100 100 100 100 100 105 105 100 100 100 100 100 100 100 100 105 100 105 100 105 100 904 904 904 904 904 100 100 100 100 904 904 100 103 103 103 103 103 999
103 103 103 103 103 100 100 100 103 103 103 103 103 103 103 100 100 105 105 100 100 100 100 100 100 100 100 100 100 100 100 100 100 100 904 904 904 904 904 904 904 904 904 904 100 103 103 103 103 103 999
103 103 103 103 103 100 100 100 103 108 103 103 103 108 103 100 100 105 105 108 108 108 108 108 108 108 100 105 100 105 100 105 100 100 904 904 904 904 904 904 904 904 904 904 100 103 103 103 103 103 999
103 103 103 103 103 100 100 100 103 108 103 108 103 108 103 100 100 105 921 100 100 100 100 100 100 108 100 100 100 100 100 100 100 100 100 904 904 904 904 904 904 904 904 100 100 103 103 103 103 103 999
103 103 103 103 103 100 100 100 103 108 103 108 103 108 103 100 100 105 105 100 100 100 100 100 100 108 100 100 100 100 941 105 100 100 108 904 904 904 904 100 100 100 100 100 100 103 103 103 103 103 999
103 103 103 103 103 100 100 100 103 103 108 103 108 103 103 100 100 105 105 100 100 100 100 100 100 108 100 100 108 108 108 100 100 108 100 100 904 100 100 100 100 100 100 100 100 103 103 103 103 103 999
103 103 103 103 103 100 100 100 103 103 103 103 103 103 103 100 100 105 105 105 100 100 100 100 100 100 108 100 100 100 100 100 108 100 100 100 100 100 100 100 100 100 100 100 100 103 103 103 103 103 999
904 904 103 103 103 100 100 100 100 100 100 100 100 100 100 100 100 105 105 100 100 100 100 100 100 100 100 108 100 100 100 108 100 100 100 100 100 100 100 100 100 100 100 100 100 103 103 103 103 103 999
103 103 904 904 103 100 100 911 100 100 100 100 100 100 100 100 100 105 105 100 100 100 100 100 100 100 100 100 108 100 108 100 100 100 100 100 100 100 100 100 100 100 100 100 100 103 103 103 103 103 999
103 103 103 904 904 904 904 904 100 911 100 100 100 100 100 100 100 105 105 912 105 100 100 100 100 100 100 100 100 921 941 100 100 100 100 100 100 100 100 100 100 100 100 100 100 103 103 103 103 103 999
103 103 103 103 103 108 108 904 100 100 100 100 100 100 100 100 100 921 100 100 105 100 100 100 100 100 100 100 108 108 108 100 100 100 100 100 100 100 100 100 100 100 100 100 100 103 103 103 103 103 999
103 103 103 103 103 108 108 904 100 100 100 100 100 100 100 100 100 105 100 100 105 100 100 100 100 100 100 108 100 100 100 108 100 100 100 100 100 100 100 100 100 100 100 100 100 103 103 103 103 103 999
103 103 103 103 103 108 108 904 100 100 100 100 100 100 100 100 100 921 100 100 105 100 100 100 100 100 108 100 100 100 100 100 108 100 100 100 100 100 100 100 100 100 100 100 100 103 103 103 103 103 999
103 103 103 103 103 904 904 904 105 105 100 100 100 100 100 100 100 105 105 100 105 100 100 100 100 108 100 100 100 911 100 100 100 108 100 100 100 100 100 100 100 100 100 100 100 103 103 103 103 103 999
103 103 103 103 103 904 100 100 105 105 100 105 105 100 100 100 100 105 105 100 100 100 100 100 100 108 100 100 100 100 100 100 100 100 108 100 100 100 100 100 100 100 100 100 100 103 103 103 103 103 999
103 103 103 103 904 904 100 100 105 105 931 105 105 100 100 100 100 105 105 100 100 100 100 100 100 108 100 100 100 100 941 100 100 100 100 108 100 100 100 100 100 100 100 100 100 103 103 103 103 103 999
103 103 103 103 904 100 100 100 105 105 100 105 105 100 100 100 100 105 105 100 100 100 100 100 100 108 100 100 100 100 100 100 100 100 100 108 100 100 100 100 100 100 100 100 100 103 103 103 103 103 999
904 904 103 904 103 100 100 100 100 100 100 100 100 100 100 100 100 904 904 904 904 100 100 100 100 108 100 911 100 100 100 100 100 100 100 108 100 100 100 100 100 100 100 100 100 103 103 103 103 103 999
103 103 904 103 103 200 100 100 100 100 100 100 100 100 100 100 904 904 904 904 904 904 904 100 100 108 100 100 100 100 100 100 100 100 100 100 100 100 100 100 100 100 100 100 100 103 103 103 103 103 999
103 103 103 103 103 103 103 103 103 103 103 103 103 103 103 103 103 103 103 103 103 103 103 103 103 103 103 103 103 103 103 103 103 103 103 103 103 103 103 103 103 103 103 103 103 103 103 103 103 103 999
103 103 103 103 103 103 103 103 103 103 103 103 103 103 103 103 103 103 103 103 103 103 103 103 103 103 103 103 103 103 103 103 103 103 103 103 103 103 103 103 103 103 103 103 103 103 103 103 103 103 999
103 103 103 103 103 103 103 103 103 103 103 103 103 103 103 103 103 103 103 103 103 103 103 103 103 103 103 103 103 103 103 103 103 103 103 103 103 103 103 103 103 103 103 103 103 103 103 103 103 103 999