103 103 103 103 103 103 103 103 103 103 103 103 103 103 103 103 103 103 103 103 103 103 103 103 103 103 103 103 103 103 103 103 103 103 103 103 103 103 103 103 103 103 103 103 103 103 103 103 103 103 999
103 103 103 103 103 103 103 103 103 103 103 103 103 103 103 103 103 103 103 103 103 103 103 103 103 103 103 103 103 103 103 103 103 103 103 103 103 103 103 103 103 103 103 103 103 103 103 103 103 103 999
103 103 103 103 103 103 103 103 103 103 103 103 103 103 103 103 103 103 103 103 103 103 103 103 103 103 103 103 103 103 103 103 103 103 103 103 103 103 103 103 103 103 103 103 103 103 103 103 103 103 999
103 103 103 103 103 100 204 103 100 100 100 100 100 100 205 100 100 100 904 204 100 100 100 100 100 100 100 100 100 100 100 100 100 100 100 100 100 100 108 100 941 100 100 100 931 103 103 103 103 103 999
103 103 103 103 103 914 204 103 100 100 100 100 100 100 100 100 100 100 904 100 100 100 100 100 100 904 904 904 100 100 100 100 100 100 100 100 100 100 108 100 100 100 100 100 100 103 103 103 103 103 999
103 103 103 103 103 100 204 103 100 100 100 100 100 100 100 100 100 100 904 904 904 904 904 904 904 904 100 100 100 100 100 100 100 103 100 100 100 100 108 100 100 100 931 100 100 103 103 103 103 103 999
103 103 103 103 103 100 103 103 100 100 100 912 100 100 100 100 100 100 904 100 100 100 100 100 100 100 100 100 100 100 100 100 100 103 103 103 100 100 108 100 100 100 100 100 100 103 103 103 103 103 999
103 103 103 103 103 100 100 100 100 100 100 100 100 100 100 100 100 100 904 100 100 105 100 105 100 105 100 105 100 100 100 100 100 103 100 204 103 100 100 100 100 100 100 100 100 103 103 103 103 103 999
103 103 103 103 103 100 108 100 100 100 108 100 108 100 100 100 108 100 904 100 100 105 100 105 100 105 100 105 100 100 100 100 100 103 100 100 103 100 100 100 941 100 100 100 941 103 103 103 103 103 999
103 103 103 103 103 100 108 100 100 100 108 100 108 100 100 100 108 100 100 100 100 105 100 105 100 105 100 105 100 100 100 100 100 103 100 204 103 100 100 100 100 100 100 100 100 103 103 103 103 103 999
103 103 103 103 103 100 108 921 108 921 108 100 108 921 108 921 108 100 904 100 100 105 912 105 100 105 100 105 100 100 100 100 100 103 100 103 100 100 103 100 100 108 108 108 108 103 103 103 103 103 999
103 103 103 103 103 100 100 108 100 108 100 100 100 108 100 108 100 100 904 100 100 105 100 105 912 105 100 105 100 100 100 100 100 103 100 100 100 100 100 100 100 100 100 100 100 103 103 103 103 103 999
103 103 103 103 103 100 100 100 100 100 100 100 100 100 100 100 100 100 904 100 100 105 100 105 100 105 912 105 100 100 100 100 100 103 103 100 100 100 100 100 100 100 100 100 100 103 103 103 103 103 999
103 103 103 103 103 100 100 100 100 100 100 100 100 100 100 100 100 100 904 100 100 105 100 105 100 105 100 105 100 100 100 100 100 103 100 103 100 100 100 100 100 100 100 100 100 103 103 103 103 103 999
103 103 103 103 103 931 100 100 100 100 100 100 100 100 100 931 100 100 904 100 100 100 100 100 100 100 100 100 100 100 100 100 100 103 100 103 100 100 100 100 100 100 100 100 100 103 103 103 103 103 999
103 103 103 103 103 100 100 100 100 100 100 100 100 100 100 100 100 100 904 100 100 100 100 100 100 100 100 100 100 100 100 100 100 103 100 100 103 100 100 100 100 100 100 100 100 103 103 103 103 103 999
103 103 103 103 103 100 100 100 100 100 100 100 100 100 100 100 100 100 904 100 100 100 105 100 105 100 105 100 100 100 100 100 100 103 100 100 103 100 100 100 100 100 100 100 100 103 103 103 103 103 999
103 103 103 103 103 100 100 100 100 100 100 912 100 100 100 100 100 100 904 100 100 100 100 100 100 100 100 100 100 100 100 100 100 100 100 100 100 100 100 100 100 100 100 100 100 103 103 103 103 103 999
103 103 103 103 103 100 100 100 100 100 901 100 100 901 100 100 100 100 904 100 100 100 100 100 100 100 100 103 103 103 100 103 103 103 100 100 100 103 103 103 100 100 100 100 100 103 103 103 103 103 999
103 103 103 103 103 100 100 100 100 100 901 100 100 901 100 100 100 100 904 100 100 100 100 921 100 921 100 103 100 103 100 103 100 103 100 100 100 103 100 103 100 100 100 100 100 103 103 103 103 103 999
103 103 103 103 103 100 100 100 100 100 901 100 912 901 100 100 100 941 100 100 103 103 100 100 100 100 100 103 914 103 100 103 100 103 100 100 100 103 912 103 100 100 100 100 100 103 103 103 103 103 999
107 107 107 107 107 107 107 107 107 107 107 100 100 107 107 107 107 107 107 107 107 103 100 100 100 100 100 103 100 103 103 103 912 103 103 103 103 103 100 103 100 100 100 100 100 103 103 103 103 103 999
904 904 904 904 904 904 904 904 904 904 904 914 100 904 904 904 904 904 904 904 904 103 100 100 100 100 100 103 100 100 100 100 100 100 100 911 100 100 100 103 100 100 100 100 100 103 103 103 103 103 999
107 107 107 107 107 107 107 107 107 107 107 100 100 107 107 107 107 107 107 107 107 103 100 100 100 100 100 103 100 103 103 103 100 103 103 103 103 103 100 103 100 100 100 100 100 103 103 103 103 103 999
103 103 103 103 103 100 100 100 100 100 901 100 100 901 100 100 100 100 100 100 103 103 100 100 100 100 100 103 100 103 100 103 100 103 100 100 100 103 100 103 100 100 100 100 100 103 103 103 103 103 999
103 103 103 103 103 100 100 100 100 100 901 100 100 901 100 100 100 100 100 100 100 100 100 100 100 100 100 103 100 103 100 103 100 103 100 100 100 103 100 103 100 100 100 100 100 103 103 103 103 103 999
103 103 103 103 103 100 100 100 100 100 901 100 914 901 100 100 100 100 100 100 100 100 100 100 100 100 100 103 100 103 100 103 100 103 100 100 100 103 914 103 100 100 100 100 100 103 103 103 103 103 999
103 103 103 103 103 100 100 100 100 100 100 100 100 100 100 100 100 100 100 100 100 100 100 100 100 100 100 103 100 103 100 103 100 103 100 100 100 103 100 103 100 100 100 100 100 103 103 103 103 103 999
103 103 103 103 103 921 100 100 100 100 100 100 100 100 100 100 100 100 100 100 108 100 100 100 100 100 100 100 100 100 100 103 100 103 100 100 100 103 100 100 100 100 921 100 100 103 103 103 103 103 999
103 103 103 103 103 904 904 904 904 904 904 921 100 100 100 100 100 100 100 100 100 100 100 108 100 100 904 100 100 100 100 103 103 103 100 100 100 103 100 100 100 100 100 921 100 103 103 103 103 103 999
103 103 103 103 103 904 904 904 904 904 904 904 904 904 921 100 100 100 100 100 108 100 100 100 100 100 904 904 100 100 100 100 100 100 100 100 100 103 100 100 100 100 100 100 921 103 103 103 103 103 999
103 103 103 103 103 904 904 904 904 904 904 904 904 904 904 904 904 921 100 100 100 100 100 108 100 100 904 904 904 100 100 103 100 100 100 911 100 100 103 103 100 100 100 100 100 103 103 103 103 103 999
103 103 103 103 103 103 103 103 103 103 103 103 103 103 100 100 100 100 100 100 100 100 100 100 100 904 904 904 100 100 100 100 100 100 108 100 108 100 100 100 100 100 100 100 100 103 103 103 103 103 999
103 103 103 103 103 103 103 103 103 103 103 103 103 103 100 100 100 100 100 100 100 100 100 100 100 904 904 921 100 100 100 100 100 100 108 100 108 100 100 100 100 100 100 100 100 103 103 103 103 103 999
103 103 103 103 103 103 921 103 921 103 921 103 921 103 100 100 100 100 100 100 100 100 100 100 100 100 904 100 100 100 100 100 100 100 108 921 108 100 100 100 100 100 100 100 100 103 904 904 904 904 999
103 103 103 103 103 100 100 100 100 100 100 100 100 100 100 100 100 100 100 100 100 100 100 100 100 100 100 100 100 100 100 100 100 100 108 921 108 100 100 100 100 100 904 904 904 904 904 103 103 103 999
103 103 103 103 103 100 100 100 100 100 100 100 100 100 100 100 100 100 100 100 100 100 100 100 100 911 100 100 100 100 100 108 108 108 108 921 108 108 108 904 904 100 904 100 100 103 103 103 103 103 999
103 103 103 103 103 204 100 100 100 100 100 100 100 100 100 100 100 100 100 100 100 100 100 100 100 100 100 100 100 100 100 108 100 100 100 100 100 100 100 100 901 100 901 100 100 103 103 103 103 103 999
103 103 103 103 103 204 100 100 100 100 100 100 100 100 100 100 100 100 100 100 100 100 100 100 100 100 100 911 100 100 100 108 100 100 100 100 100 100 100 100 901 100 901 100 100 103 103 103 103 103 999
103 103 103 103 103 100 100 100 100 100 100 100 100 100 100 100 100 100 100 100 108 108 103 108 108 108 108 108 108 108 108 108 100 100 100 100 100 100 100 100 100 100 100 100 100 103 103 103 103 103 999
103 103 103 103 103 100 100 100 100 100 100 100 100 100 100 100 100 100 100 100 108 103 100 100 100 100 100 108 108 108 100 100 100 105 105 100 105 105 100 100 100 901 100 100 100 103 103 103 103 103 999
103 103 103 103 103 100 108 921 108 921 108 921 108 100 108 100 108 100 108 100 103 100 100 100 100 100 100 108 108 108 100 100 100 105 105 100 105 105 100 100 901 901 901 100 100 103 103 103 103 103 999
103 103 103 103 103 108 108 108 108 108 108 108 108 108 108 108 108 108 108 108 108 100 100 100 100 100 100 100 108 100 100 100 100 105 105 912 105 105 100 100 100 108 100 100 931 103 103 103 103 103 999
103 103 103 103 103 100 100 100 100 100 100 100 100 100 100 100 100 100 941 108 100 100 100 100 912 100 914 100 108 100 100 100 100 105 105 100 105 105 100 100 100 108 100 100 100 103 103 103 103 103 999
103 103 103 103 103 100 100 100 100 108 913 100 100 100 100 100 108 100 100 108 100 100 100 100 100 100 100 108 108 108 100 100 100 105 105 100 105 105 100 100 100 108 100 100 100 103 103 103 103 103 999
103 103 103 103 103 100 100 100 100 100 100 100 100 921 100 100 108 100 100 108 100 100 100 100 100 100 100 100 100 100 100 100 100 100 100 100 100 100 100 100 100 108 100 100 931 103 103 103 103 103 999
103 103 103 103 103 200 100 100 100 108 913 100 100 100 100 100 108 941 100 100 100 100 100 100 100 100 100 100 100 100 100 100 100 100 100 100 100 100 100 100 100 100 100 100 100 103 103 103 103 103 999
103 103 103 103 103 103 103 103 103 103 103 103 103 103 103 103 103 103 103 103 103 103 103 103 103 103 103 103 103 103 103 103 103 103 103 103 103 103 103 103 103 103 103 103 103 103 103 103 103 103 999
103 103 103 103 103 103 103 103 103 103 103 103 103 103 103 103 103 103 103 103 103 103 103 103 103 103 103 103 103 103 103 103 103 103 103 103 103 103 103 103 103 103 103 103 103 103 103 103 103 103 999
103 103 103 103 103 103 103 103 103 103 103 103 103 103 103 103 103 103 103 103 103 103 103 103 103 103 103 103 103 103 103 103 103 103 103 103 103 103 103 103 103 103 103 103 103 103 103 103 103 103 999